BBBB...B...BBBB
BHB.###.###.BHB
BB.#.B.#.B.#.BB
B.#.BBBBBBB.#.B
B.#BBBBBBBBB#.B
B.#.BBBBBBB.#.B
B.#BBBHHHBBB#.B
BB.#PBBBBB.#.BB
BBB.#BBBBB#.BBB
BBBB.#.B.#.BBBB
BB.BB.###.BB.BB
BH.BBB...BBB.HB
B..BBBBBBBBB..B