BBBB.P.B.P.BBBB
BHB.###.###.BHB
BB.#.B.#.B.#.BB
B.#.BBBBBBB.#.B
B.#BBBBBBBBB#.B
BP#.BBBBBBB.#PB
B.#BBBHHHBBB#.B
BB.#PBBBBBP#.BB
BBB.#BBBBB#.BBB
BBBB.#.B.#.BBBB
BB.BB.###.BB.BB
BH.BBB...BBB.HB
B.PBBBBBBBBBP.B